"filename", "language", "TypeScript", "CSS", "comment", "blank", "total"
"c:\Users\Ljubo\Documents\GitHub\Note-Taker\client\src\Components\Navbar\NavbarLogic.ts", "TypeScript", -7, 0, 7, 0, 0
"c:\Users\Ljubo\Documents\GitHub\Note-Taker\client\src\Components\NoteEditor\NoteEditor.ts", "TypeScript", -27, 0, 0, -4, -31
"c:\Users\Ljubo\Documents\GitHub\Note-Taker\client\src\Components\NoteEditor\NoteEditorLogic.ts", "TypeScript", 48, 0, 91, 5, 144
"c:\Users\Ljubo\Documents\GitHub\Note-Taker\client\src\Components\NoteEditor\noteStyling.css", "CSS", 0, 132, 0, 16, 148
"c:\Users\Ljubo\Documents\GitHub\Note-Taker\client\src\Components\PopupWindows\SelectColor\SelectColor.ts", "TypeScript", 13, 0, 0, 2, 15
"c:\Users\Ljubo\Documents\GitHub\Note-Taker\client\src\Components\PopupWindows\SelectColor\SelectColorLogic.ts", "TypeScript", 49, 0, 0, 7, 56
"c:\Users\Ljubo\Documents\GitHub\Note-Taker\client\src\Components\Sidebar\SidebarFolderLogic.ts", "TypeScript", 137, 0, -4, 3, 136
"c:\Users\Ljubo\Documents\GitHub\Note-Taker\client\src\Components\Sidebar\SidebarLogic.ts", "TypeScript", 4, 0, 0, 1, 5
"c:\Users\Ljubo\Documents\GitHub\Note-Taker\client\src\Components\Sidebar\sidebarStyling.css", "CSS", 0, 7, 0, 0, 7
"c:\Users\Ljubo\Documents\GitHub\Note-Taker\client\src\Pages\Main\index.ts", "TypeScript", -14, 0, 11, 1, -2
"c:\Users\Ljubo\Documents\GitHub\Note-Taker\client\src\Services\NoteService.ts", "TypeScript", -11, 0, 0, 0, -11
"c:\Users\Ljubo\Documents\GitHub\Note-Taker\client\src\Stores\GlobalStore.ts", "TypeScript", 2, 0, 0, -1, 1
"c:\Users\Ljubo\Documents\GitHub\Note-Taker\client\src\Stores\NoteStore.ts", "TypeScript", 53, 0, 0, 5, 58
"c:\Users\Ljubo\Documents\GitHub\Note-Taker\client\src\Stores\ProjectStore.ts", "TypeScript", 12, 0, 0, -1, 11
"c:\Users\Ljubo\Documents\GitHub\Note-Taker\client\src\Utils\GeneralFunctions.ts", "TypeScript", 48, 0, 5, 1, 54
"c:\Users\Ljubo\Documents\GitHub\Note-Taker\client\src\Utils\Router\Router.ts", "TypeScript", 1, 0, 0, 0, 1
"c:\Users\Ljubo\Documents\GitHub\Note-Taker\client\src\Utils\Router\RouterLogic.ts", "TypeScript", 17, 0, 0, 2, 19
"c:\Users\Ljubo\Documents\GitHub\Note-Taker\client\src\Utils\TsTypes.ts", "TypeScript", 9, 0, 0, 1, 10
"Total", "-", 334, 139, 110, 38, 621