"filename", "language", "TypeScript", "CSS", "comment", "blank", "total"
"c:\Users\Ljubo\Documents\GitHub\Note-Taker\client\src\Components\Navbar\NavbarLogic.ts", "TypeScript", 10, 0, 0, 2, 12
"c:\Users\Ljubo\Documents\GitHub\Note-Taker\client\src\Components\NoteEditor\NoteEditor.ts", "TypeScript", 16, 0, 0, -2, 14
"c:\Users\Ljubo\Documents\GitHub\Note-Taker\client\src\Components\NoteEditor\NoteEditorLogic.ts", "TypeScript", 70, 0, -2, 9, 77
"c:\Users\Ljubo\Documents\GitHub\Note-Taker\client\src\Components\Sidebar\Sidebar.ts", "TypeScript", -57, 0, 0, -6, -63
"c:\Users\Ljubo\Documents\GitHub\Note-Taker\client\src\Components\Sidebar\SidebarLogic.ts", "TypeScript", 35, 0, 0, 7, 42
"c:\Users\Ljubo\Documents\GitHub\Note-Taker\client\src\Components\Sidebar\sidebarStyling.css", "CSS", 0, 1, 0, 0, 1
"c:\Users\Ljubo\Documents\GitHub\Note-Taker\client\src\Pages\Home\index.ts", "TypeScript", 4, 0, 0, 0, 4
"c:\Users\Ljubo\Documents\GitHub\Note-Taker\client\src\Services\BaseService.ts", "TypeScript", 2, 0, 0, 0, 2
"c:\Users\Ljubo\Documents\GitHub\Note-Taker\client\src\Services\NoteService.ts", "TypeScript", 24, 0, 0, 2, 26
"c:\Users\Ljubo\Documents\GitHub\Note-Taker\client\src\Stores\GlobalStore.ts", "TypeScript", 2, 0, 0, 0, 2
"c:\Users\Ljubo\Documents\GitHub\Note-Taker\client\src\Utils\Date.ts", "TypeScript", -1, 0, -3, 0, -4
"c:\Users\Ljubo\Documents\GitHub\Note-Taker\client\src\Utils\Router.ts", "TypeScript", 7, 0, 0, 2, 9
"Total", "-", 112, 1, -5, 14, 122