"filename", "language", "TypeScript", "CSS", "comment", "blank", "total"
"c:\Users\Ljubo\Documents\GitHub\Note-Taker\client\src\Components\Navbar\NavbarLogic.ts", "TypeScript", 39, 0, 0, 7, 46
"c:\Users\Ljubo\Documents\GitHub\Note-Taker\client\src\Components\Navbar\navbarStyles.css", "CSS", 0, 6, 0, 0, 6
"c:\Users\Ljubo\Documents\GitHub\Note-Taker\client\src\Components\NoteEditor\NoteEditor.ts", "TypeScript", -1, 0, 0, 0, -1
"c:\Users\Ljubo\Documents\GitHub\Note-Taker\client\src\Components\NoteEditor\NoteEditorLogic.ts", "TypeScript", 10, 0, 8, 1, 19
"c:\Users\Ljubo\Documents\GitHub\Note-Taker\client\src\Components\NoteEditor\noteStyling.css", "CSS", 0, 1, 0, 1, 2
"c:\Users\Ljubo\Documents\GitHub\Note-Taker\client\src\Components\Sidebar\Sidebar.ts", "TypeScript", 0, 0, 0, -2, -2
"c:\Users\Ljubo\Documents\GitHub\Note-Taker\client\src\Components\Sidebar\SidebarLogic.ts", "TypeScript", 14, 0, 3, 0, 17
"c:\Users\Ljubo\Documents\GitHub\Note-Taker\client\src\Components\TodoList\TodoList.ts", "TypeScript", 36, 0, 0, 6, 42
"c:\Users\Ljubo\Documents\GitHub\Note-Taker\client\src\Components\TodoList\TodoListLogic.ts", "TypeScript", 21, 0, 0, 4, 25
"c:\Users\Ljubo\Documents\GitHub\Note-Taker\client\src\Components\TodoList\todoListStyles.css", "CSS", 0, 43, 0, 10, 53
"c:\Users\Ljubo\Documents\GitHub\Note-Taker\client\src\Components\UserAuth\UserAuth.ts", "TypeScript", 58, 0, 0, 13, 71
"c:\Users\Ljubo\Documents\GitHub\Note-Taker\client\src\Components\UserAuth\UserAuthLogic.ts", "TypeScript", 159, 0, 0, 26, 185
"c:\Users\Ljubo\Documents\GitHub\Note-Taker\client\src\Components\UserAuth\userAuthStyles.css", "CSS", 0, 108, 0, 17, 125
"c:\Users\Ljubo\Documents\GitHub\Note-Taker\client\src\Components\WarningMessage\GenerateMessage.ts", "TypeScript", 16, 0, 0, 6, 22
"c:\Users\Ljubo\Documents\GitHub\Note-Taker\client\src\Components\WarningMessage\WarningLogic.ts", "TypeScript", 23, 0, 0, 6, 29
"c:\Users\Ljubo\Documents\GitHub\Note-Taker\client\src\Components\WarningMessage\warningStyling.css", "CSS", 0, 70, 0, 8, 78
"c:\Users\Ljubo\Documents\GitHub\Note-Taker\client\src\Pages\Home\index.css", "CSS", 0, 1, 0, -1, 0
"c:\Users\Ljubo\Documents\GitHub\Note-Taker\client\src\Pages\Home\index.ts", "TypeScript", 22, 0, 1, 1, 24
"c:\Users\Ljubo\Documents\GitHub\Note-Taker\client\src\Services\BaseService.ts", "TypeScript", 5, 0, 0, 0, 5
"c:\Users\Ljubo\Documents\GitHub\Note-Taker\client\src\Services\NoteService.ts", "TypeScript", 12, 0, 0, 0, 12
"c:\Users\Ljubo\Documents\GitHub\Note-Taker\client\src\Services\UserService.ts", "TypeScript", 31, 0, 0, 7, 38
"c:\Users\Ljubo\Documents\GitHub\Note-Taker\client\src\Stores\GlobalStore.ts", "TypeScript", 4, 0, 0, 0, 4
"c:\Users\Ljubo\Documents\GitHub\Note-Taker\client\src\Stores\UserStore.ts", "TypeScript", 83, 0, 0, 14, 97
"c:\Users\Ljubo\Documents\GitHub\Note-Taker\client\src\Utils\Router.ts", "TypeScript", 16, 0, 0, 2, 18
"Total", "-", 548, 229, 12, 126, 915